###################
#........#........#
#.##.###.#.###.##.#
#........#........#
#.##.#.#####.#.##.#
#....#...#...#.##.#
####.###.#.###.####
#....#.......#....#
#..#.#.#####.#.#..#
####...........####
#....#########....#
#.##.#.......#.##.#
####.#.#####.#.####
#........#........#
#.##.#.#.#.#.#.##.#
#..#.#.#.#.#.#.##.#
##...#.#####.#...##
#....#...#...#....#
#.######.#.######.#
#.................#
###################