####################
#..................#
#.###.###..###.###.#
#.#...#......#...#.#
#.#.###.####.###.#.#
#.#.#..........#.#.#
#.....###..###.....#
#.#.#..........#.#.#
#.#.###.####.###.#.#
#.#...#......#...#.#
#.###.###..###.###.#
#..................#
####################