#######################
#..........#..........#
#.####.###.#.###.####.#
#.####.###.#.###.####.#
#..........#..........#
#.########.#.########.#
#.....................#
#####.###########.#####
#.....................#
#.##.#.##.###.##.#.##.#
#.#..#..#.....#..#..#.#
#.#.###.###.###.###.#.#
#.....................#
#####.###########.#####
#..........#..........#
#.###.####.#.####.###.#
#...#.............#...#
###.#.#.#######.#.#.###
#.....#....#....#.....#
#.########.#.########.#
#.....................#
#######################